Level 3 (merci à E. Porte)
32
##########
####DDD ##
#######L##
### S   H#
###S#S#  #
###  MSS##
#K#S#S# ##
#     M ##
##########