Level 5 (merci à E. Porte)
23
########
#### D##
### LB #
#H#T B #
# # T T#
#M#BBBB#
#T T  T#
######K#
########